Maps/airloo.png
47
48
                                               |
                                               |
  XXXXXXXXXXXXXXXXXXXXXXXXXXXXXXXXXXXXXXXXXXX  |
  XXXXXXXXXXXXXXXXXXXXXXXXXXXXXXXXXXXXXXXXXXX  |
  XXXXXXXXXXXXXXXXXXXXXXXXXXXXXXXXXXXXXXXXXXX  |
  X                                         X  |
  X                  XXXXX                  X  |
  X                  XXXXX                  X  |
  X   XXXX         XXXXXXXXX         XXXX   X  |
  X   XXXX       X XXXXXXXXX X       XXXX   X  |
  X   XX X       X XXXXXXXXX X       X XX   X  |
  X              X XXXXXXXXX X              X  |
  X   XXXX       X XXXXXXXXX X       XXXX   X  |
  X   XXXX       X   XXXXX   X       XXXX   X  |
  X              X   XXXXX   X              X  |
  X              X           X              X  |
  X                                         X  |
  X                 XX   XX                 X  |
  X                                         X  |
  X                                         X  |
  X                                         X  |
  X                                         X  |
  X   XXXX XXXX                 XXXX XXXX   X  |
  X   XXXX XXXX                 XXXX XXXX   X  |
  X   X XX XX X        X        X XX XX X   X  |
  X                    X                    X  |
  X   XXXX XXXX                 XXXX XXXX   X  |
  X   XXXX XXXX                 XXXX XXXX   X  |
  X                                         X  |
  X                                         X  |
  X                                         X  |
  X                                         X  |
  X                                         X  |
  X   XXXXX                                 X  |
  X   XXXXX                          XXXX   X  |
  X   XXXXX            X             XXXX   X  |
  X   XXX X           XXX            X XX   X  |
  X                   XXX                   X  |
  X   XXXXX            X             XXXX   X  |
  X   XXXXX                          XXXX   X  |
  X                                         X  |
  X                                         X  |
  X                                         X  |
  XXXXXXXXXXXXXXXXXXXX   XXXXXXXXXXXXXXXXXXXX  |
  XXXXXXXXXXXXXXXXXXXX   XXXXXXXXXXXXXXXXXXXX  |
  XXXXXXXXXXXXXXXXXXXX   XXXXXXXXXXXXXXXXXXXX  |
                                               |
                                               |
                                               |