Maps/earthloo.png
50
50
                   X          X                   |
                   X          X                   |
                   XXXXXXXXXXXXXXXXXXX            |
                  XX                  XXXX        |
              XXXX                        X       |
           XXX    XX    XXXXX        XX    XXX    |
       XXXX       XX   XXXXXXX       XX       XXXX|
   XXXX   XX          XXXXXXXX  XX             X  |
  X       XX          XXXXXXXX  XX    XX XXXXX X  |
XX                    XXXXXXXX      X XX XXXXX X  |
  X                               XX     XXXXX X  |
  X           XXXXX               XX XX  XXXXX X  |
  X XXXX     XXXXXXX                 XX  X   X X  |
  X XXXX    XX   XXXX            XXXX    XX XX X  |
  X XX X   XX    XX XX           XXXXX       X X  |
  X XX    XX         X  X   X   X XX XXX     X X  |
  X XX    XX         X  X   X   X XX XXX     X X  |
  X XX    XX         X  X   X   X XX XXX     X X  |
  X XX    XX         X  X   X   X XX XXX     X X  |
  X XX    XX         X  X   X   X XX XXX     X X  |
  X XX    XX         X  X   X   X XX XXX     X X  |
  X XX    XX         X  X   X   X XX XXX     X X  |
  X XX    XX         X  X   X   X XX XXX     X X  |
  X XX    XX         X  X   X   X XX XXX     X X  |
  X XX    XX         X  X   X   X XX XXX     X X  |
  X XX    XX         X  X   X   X XX XXX     X X  |
  X XX    XX         X  X   X   X XX XXX     X X  |
  X XX    XX         X  X   X   X XX XXX     X X  |
  X XX    XX         X  X   X   X XX XXX     X X  |
  X XX    XX         X  X   X   X XX XXX     X X  |
  X XX    XX         X  X   X   X XX XXX     X X  |
  X XX    XX         X  X   X   X XX XXX     X X  |
  X XX    XX         X  X   X   X XX XXX     X X  |
  X XX    XX         X  X   X   X XX XXX     X X  |
  X XX    XX         X  X   X   X XX XXX     X X  |
  X XX    XX         X  X   X   X XX XXX     X X  |
  X XX    XX         X  X   X   X XX XXX     X X  |
  X XX    XX         X  X   X   X XX XXX     X X  |
  X XX    XX         X  X   X   X XX XXX     X X  |
  X XX    XX         X  X   X   X XX XXX     X X  |
  X XX    XX         X  X   X   X XX XXX     X X  |
  X XX    XX         X  X   X   X XX XXX     X X  |
  X XX    XX         X  X   X   X XX XXX     X X  |
  X XX    XX         X  X   X   X XX XXX     X X  |
  X XX    XX         X  X   X   X XX XXX     X X  |
  X XX    XX         X  X   X   X XX XXX     X X  |
  X XX    XX         X  X   X   X XX XXX     X X  |
  X XX    XX         X  X   X   X XX XXX     X X  |
  X XX    XX         X  X   X   X XX XXX     X X  |
  X XX    XX         X  X   X   X XX XXX     X X  |
  X XX    XX         X  X   X   X XX XXX     X X  |
  X XX    XX         X  X   X   X XX XXX     X X  |