Maps/fireloo.png
51
51
XXXXXXXXXXXXXXXXXXXXXXXXXXXXXXXXXXXXXXXXXXXXXXXXXXX|
XXXXXXXXXXXXXXXXXXXXXXXXXXXXXXXXXXXXXXXXXXXXXXXXXXX|
XXXXXXXXXXXXXXXXXXXXXXXXXXXXXXXXXXXXXXXXXXXXXXXXXXX|
XXXXXXXXXXXXXXXXXXXXXXXXXXXXXXXXXXXXXXXXXXXXXXXXXXX|
XXXXXXXXXXXXXXXXXXXXXXXXXXXXXXXXXXXXXXXXXXXXXXXXXXX|
XXXXXXX       XXXXXXXXXXXXXXX    X   XXXXXXXXXXXXXX|
XXXXXXX   XX  XXXXXXXXXXXXX      X      XXXXXXXXXXX|
XXXXX     XX X XXXXX         XXX          XXXXXXXXX|
XXXXX   XXXX    XXXX  XX    XXXXXXXXXXX       XXXXX|
XXXXX  XXXX      XX  XXXXX  XXXXXXXXXXXXXXX    XXXX|
XXXX   XXXX  XX     XXXXXXX XXXXXXXXXXXXXXXX    XXX|
XXXX   XX    XXX   XXXXXXXX   XXXXXXXXXXXXXXXXX XXX|
XXX  X X    XXXXX XXXXXXXXXXX   XXXXXXXXXXXXXXXXXXX|
XXX  XXX   XXXXXX XXXXXXXXXXX X XXXXXXXXXXXXXXXXXXX|
XXX   XX   XXXXXXXXXXXXXXXXXX    XXXXXXXXXX   XXXXX|
XXX   XX  XXXXXXXXXXXXXXXXXXXX   XXXXXXXXX  XXXXXXX|
XXX   X   XXXXXXXXXXX   XXXXXXX    XXXXXX  XXXXXXXX|
XXX  XX   XXXXXXXXX   XXXXXXXXXXXX        XXXXXXXXX|
XXX  XXX   XXXXXXX   XXXXXXXXXXXXX XXXXXXXXXXXXXXXX|
XXXXXXXXX  XXXXXX   XXXXXXXXX XXXX      XXXXXXXXXXX|
XXXXXXXXXX  XXXX  XXXXXXXXXXX            XXXXXXXXXX|
XXXXXXXXXX  XXXX  XXXXXXXXXXXX XXXXXXXX   XXXXXXXXX|
XXXXXXXXXX  XXX  XXXXXXXXXXXXX  XXXXXXXXX       XXX|
XXXXXXXXXXX XXX  XXXXXXXXXXXXXX  X   XXXXX     XXXX|
XXXXX  XXXX XXX  XXXXXXXXXXXXXXX      XXXXXXX  XXXX|
XXXXX  XXX  XXX   XXXXXXXXXXXXXXX XXX  XXXXXXXXXXXX|
XXXXX  XXX XXXXX  X  XXXXXXXXXXXXXXXXX XXXXXXXXXXXX|
XXXX  XXXXXXXXXXX    XXXXXXXXXXXXXXXXX  XXXXXXXXXXX|
XXXX  XXXXXXXXXXXX    XXXXXXXXXXX XXXXX  XXXXXXXXXX|
XXXX   XXXXX  XXXXX    XXXXXXXXXX  XXXX      XXXXXX|
XXXX   XXXXX   XXXXX   XXXXXXXXXXX XXXX    X XXXXXX|
XXXX X XXX      XXXXX   XXXXXXXXXX XXXXX   X XXXXXX|
XXXX X XXX   XXXXXXXXXX  XXXXXXXX  XXXXXX     XXXXX|
XXXX        XXXXXXXXXXXX  XXXXXXX    XXXXXX   XXXXX|
XXXX    XXXXXXXXXXXXXXXXX  XXXXXX XX   XXXX   XXXXX|
XXXX    XXXXXXXXXXX   XXXX        XXX   XXXX   XXXX|
XXXX   XXXXXXXXXX      XXXXXXXXXXXXXXX  XXXX   XXXX|
XXXX   XXXXXXXXX        XXXXXXXXXXXXXXX   XX   XXXX|
XXXXXX   XXXXXXXX        X XXXXXXXXXXXXXX     XXXXX|
XXXXXX    XXXXXXXX XX  XXX  XXXXXXXXXXXXXX    XXXXX|
XXXXXXXX   XXXXXXX XXXXXXX  XXXXXXXXXXXXXX X XXXXXX|
XXXXXXXXXX      XX XXXXXXX  XX  XXXXX       XXXXXXX|
XXXXXXXXXXX         XXXX         XXX      XXXXXXXXX|
XXXXXXXXXXXXXXX          XXXXX      X   XXXXXXXXXXX|
XXXXXXXXXXXXXXXXXXX    XXXXXXXXX    X  XXXXXXXXXXXX|
XXXXXXXXXXXXXXXXXXXXXXXXXXXXXXXXXXX   XXXXXXXXXXXXX|
XXXXXXXXXXXXXXXXXXXXXXXXXXXXXXXXXXX   XXXXXXXXXXXXX|
XXXXXXXXXXXXXXXXXXXXXXXXXXXXXXXXXXX   XXXXXXXXXXXXX|
XXXXXXXXXXXXXXXXXXXXXXXXXXXXXXXXXXX   XXXXXXXXXXXXX|
XXXXXXXXXXXXXXXXXXXXXXXXXXXXXXXXXXX   XXXXXXXXXXXXX|
XXXXXXXXXXXXXXXXXXXXXXXXXXXXXXXXXXX   XXXXXXXXXXXXX|