Maps/waterloo.png
43
46
                                           |
                                           |
  XXXXXXXXXXXXXXXXXXXXXXXXXXXXXXXXXXXXXXX  |
  XXXXXXXXXXXXXXXXXXXXXXXXXXXXXXXXXXXXXXX  |
  XXXXXXXXXXXXXXXXXXXXXXXXXXXXXXXXXXXXXXX  |
  XXXXXXXXXXXXXXXXXXXXXXXXXXXXXXXXXXXXXXX  |
  XXXXXXXXXXXXXXXXXXXXXXXXXXXXXXXXXXXXXXX  |
  XXXXXXXXXXXXXXXXXXXXXXXXXXXXXXXXXXXXXXX  |
  XXXXXXXXXXXXXXXXX        XXXXXXXXXXXXXX  |
  XXXXXXXXXXXXXXXXX XXXXXX XXXXXXXXXXXXXX  |
  XXXXXXXXXXXXXXXXX        XXXXXXXXXXXXXX  |
  XXXXXXXXXXXXXXXXXX     X XXXXXXXXXXXXXX  |
  XXXXXXXXXXXXXXXXXX     X XXXXXXXXXXXXXX  |
  XXXXXXXXXXXXXXXXXXXX    X XXXXXX XXXXXX  |
  XXXXXXXXXXXXXX XX   XX X     XX       X  |
  XXXXXXXXXXXXXX    XX     XXX     XXXX X  |
  XXX  XXX X XXX    XX     XXX X   XXXX X  |
  X  X XX    XXX  XXXX     X X X   X XX X  |
  X   XXX   XXXX  XXXX   X              X  |
  XXX XX     XX   XX X        X       X X  |
  XXX  XX   XX   X          X X  XX   X X  |
  X         X   XX   X      X    XX     X  |
  X XXXXX   X   X    X    XX XXXXX   X  X  |
  X XXXXX   X   XXXXXX    XX XXXXX   X  X  |
  X XXXXX   XXX XXXXXX  XXXX XXXXX      X  |
  X XXXXX   XXX XXXXXX  XXXX XXXXX      X  |
  X XXXXX   XXX X XX X  XX X XXX X   XX X  |
  X XX XX                            XX X  |
  XXX                                 X X  |
  XXX                   XX        XXX X X  |
  X   XXXXXXX  XXX XXXX XX XXXX   XXX   X  |
  X XXXXXXXXX  XXX XXXX    XXXX   X X XXX  |
  X XXXXX XXX  XXX XXXX    XX X      XXXX  |
  X  XX            X      XX         XXXX  |
  X XXXXXXXXX      X  XX XXX          XXX  |
  X X      XX         XX XXX  X   XX  XXX  |
  X XXXX XXXX  XXXXX     XXXXX    XXX XXX  |
  X XXXX XXXX  XXXXX     XXXXX     XX XXX  |
  X XXXX XXXX   X XX X   XXX XX     XXXXX  |
  X X              X X   XXXXXX   XXXXXXX  |
  X XXXXXXXXX      X      XXXX    XX  XXX  |
  XXXXXXXXXXXXXXXXXXXXXXXXXXXXX   XXXXXXX  |
  XXXXXXXXXXXXXXXXXXXXXXXXXXXXX   XXXXXXX  |
  XXXXXXXXXXXXXXXXXXXXXXXXXXXXX   XXXXXXX  |
                                           |
                                           |