Maps/waterloo.png
43
46
                                           |
                                           |
  XXXXXXXXXXXXXXXXXXXXXXXXXXXXXXXXXXXXXXX  |
  XXXXXXXXXXXXXXXXXXXXXXXXXXXXXXXXXXXXXXX  |
  XXXXXXXXXXXXXXXXXXXXXXXXXXXXXXXXXXXXXXX  |

  X XXXXX XXX  XXX
  X  XX            X      XX         XXXX  |
  X XXXXXXXXX      X  XX XXX          XXX  |
  X X      XX         XX XXX  X   XX  XXX  |
  X XXXX XXXX  XXXXX     XXXXX    XXX XXX  |
  X XXXX XXXX  XXXXX     XXXXX     XX XXX  |
  X XXXX XXXX   X XX X   XXX XX     XXXXX  |
  X X              X X   XXXXXX   XXXXXXX  |
  X XXXXXXXXX      X      XXXX    XX  XXX  |
  XXXXXXXXXXXXXXXXXXXXXXXXXXXXX   XXXXXXX  |
  XXXXXXXXXXXXXXXXXXXXXXXXXXXXX   XXXXXXX  |
  XXXXXXXXXXXXXXXXXXXXXXXXXXXXX   XXXXXXX  |
                                           |
                                           |