Maps/waterloo.png
43
46
                                           |
                                           |
  XXXXXXXXXXXXXXXXXXXXXXXXXXXXXXXXXXXXXXX  |
  XXXXXXXXXXXXXXXXXXXXXXXXXXXXXXXXXXXXXXX  |
  XXXXXXXXXXXXXXXXXXXXXXXXXXXXXXXXXXXXXXX  |
  X    XX XX XX  X   X  XX        XX X  X  |
  X  XX      XX      X XX  X         XXXX  |
  X  XX        XX   XXXXX  X    XXX   XXX  |
  X XX XXXXXXX XXX X       XX XXXXXXX   X  |
  X XXX XX XX X  X X XXXXX XXXXXXXXXXX  X  |
  X   X    XX  X   X